A	AH
A(2)	EY
BEER	B IH R
BOTTLE	B AA T AH L
BRING	B R IH NG
BUDDY	B AH D IY
CAN	K AE N
CAN(2)	K AH N
CLIMB	K L AY M
COFFE	K AA F IY
COKE	K OW K
COME	K AH M
FETCH	F EH CH
FROM	F R AH M
GET	G EH T
GET(2)	G IH T
GO	G OW
HELLO	HH AH L OW
HELLO(2)	HH EH L OW
HERE	HH IY R
HEY	HH EY
HI	HH AY
KITCHEN	K IH CH AH N
ME	M IY
PIZZA	P IY T S AH
STAIRS	S T EH R Z
STOP	S T AA P
THE	DH AH
THE(2)	DH IY
THERE	DH EH R
TO	T UW
TO(2)	T IH
TO(3)	T AH
WATER	W AO T ER
YOU	Y UW
